111111111111
1110ECP00001
111111111111